NO   	./img/up.xpm    
SO ./img/down.xpm
WE          ./img/right.xpm
EA ./img/left.xpm

C 5,220,255
F 111,255,111

        1111111111111111111111111
        101110000011000N000000001
        10110000011100000000000001
        10010000000000000000000001
111111111011000001110000000000011
100000000011000001110111111111111
11110111111111011100000010001
11110111111111011101010010001
11000000110101011100000010001
10000000000000001100000010011
10000000000000001101010010001
11000001110101011111011110001
11110111 1110101 101111010001
11111111 1111111 111111111111