NO   	./img/up.xpm
SO ./img/down.xpm
WE      ./img/right.xpm
EA ./img/left.xpm
C 5,220,255
F 111,255,111
    1111111111111111111111111
111110000011000N000000001
1011000001110000000000001
1001000000000000000000001
11111111101100001110000011111111
100000000011000001110111111111111
11110111111111011100000010001
11110111111111011101010010001
11111111110101011100000010001
1000000000000001100011111111
1000000000000001101010010001
100000111010101 111011110001
1110111 1110101 101111010001
1111111 1111111 111111111111