WE      ../textures/text3.xpm
NO ../textures/text1.xpm
SO      ../textures/text2.xpm
EA ../textures/text4.xpm

C 52,126,223
F 179,179,108

        111111111111111111111
        100000000011000000001
        101100000111000000001
        100100000000000000001
11111111101100000111000000001
10000000001100000111011110111
11110111111111011100000010001
11110111111111011101010010001
11000000000000011100001000001
10000010000000000000000000001
10001010000000001101010010001
11000101110101011111011110001111
11110111 1110101 1011110100N1
11111111 1111111 111111111111